EEWEWEEEEE
EEWEEWEEEW
EEEWWWWEWE
WEEWWWEEEE
EWWWEEEWEE
WEWWEEWEEE
WEWEWWWWEE
EWWEEWWWWW
WEWEWWWEEE
EWEWEWEEEW
