EWEWEWEWWE
EWEWWEWWWW
EWEWWWEWEE
EEEWWEWEWW
WWEWEEEEEW
WEWEEWWWWE
EEEEWWEWWW
WWEEEEWWEW
EWEEWWWEWE
WEEEEWEWWW
WEEWEEEEW
EWWWEEWEEE
WEWEWWWEWE
WEEWWEEWWE
WEWEWWWWWE
WWWEWEWWWW
EWEEWEWEEE
EWWEEEWWEE
WWEWEWEEEE
WWWWEEEWWW
