EEWEWWEWWE
WEWWEEEWWW
WEEWWWEEWW
EEWWWWEEEE
WWEWWWEWEE
WWEEEWWWEW
WWWWEWWEWW
EEWEEWEWEW
EEEWEWEWEE
WEWEEWWWEW
